000000000000
000000000000
000000000000
000000000000
000001110000
000001410000
001111310000
001423511100
001113234100
000012111100
000014100000
000011100000