000000000000
001111111000
001254441000
001222221100
011132222100
012222222100
012321312100
012221222100
011111111100
000000000000
000000000000
000000000000